1111111111
1P001000E1
1001110001
1C00100001
1000110001
100C1C0001
1000110001
100000C001
1C000000C1
1111111111