1111111
1P00001
1C00C01
1000001
1C000E1
1000001
1111111