111111
1P00C1
111101
1000E1
1C0001
111111
