11111
1PC01
100C1
1E001
11111
