11111
1P001
100C1
10C01
1E111
