1111111111
1P000000E1
1001110001
1C00100001
1000110001
100C100001
1000110001
100000C001
1C00000001
1111111111
