11111
1P001
100C1
10CE1
10111
