111111
1P0C01
100C01
1C0001
1E0011
111111
