111111
1PH001
1C0E01
100001
10C001
111110