111111
1P0C01
1P00E1
1C00E1
1C0001
111111
