1111111
1P00001
1111111
1C000E1
1111111
1000001
1111111
