111111
1P0001
100C01
1C0001
E00011
111110
