111111
1P0001
1C0E01
100001
10C001
111110
