111111111111111
1P000000C000001
111011101110101
100010001000001
101110111C11101
101000C01000001
101011101011101
101000001000001
101111011011101
10000001001E101
101110111010001
1000100C1000101
101011111110101
1C0000000000001
111111111111111