11111111111111111111111111111111111111111111111111
1P000000000000000000000000000000000000000000000001
10001111111110000000000000000111111111111111000001
1000000000011000000C000000001000000000000010000001
11110000000111111000000000111100000000000001000001
10000000000000000000000000100000000000000001000001
10000111111111111110001111100000000000000001000001
10000100000000000000000000000000011111111111000001
10000100000000111111111111111111110000000000000001
10000100000000000000000000000000000000000000000001
10000100000000000001111111111110000000000000000001
10000100000000000001000000000110000000000000000001
10000100000000000001000000000111111111111111110001
10000100000000000001000000000110000000000000010001
10000100000000000001000000000110000000000000010001
10000111111111111111000000000110000000000000010001
10000000000000000000000000000110000000000000010001
10000000000000000001111111111110000000000000010001
10000000000000000000000000000000000000000000010001
100000000000000000000000000000000000000000000E0001
11111111111111111111111111111111111111111111111111
