111111
1P0001
100001
100001
1E0001
111111
