1111111111
1P00000001
1000010001
1000C00001
1000000C01
1C000000E1
1XXXXXXXX1
1000000001
1C00000001
1111111111
