1111111111111111
1C000001E10000C1
1011110000011101
100001111111C101
1111010000000101
1000010111010101
10111101P1000001
1000000000011111
1110101111010001
1000000C1001C101
1011111110111101
1C00000000000001
1111111111111111
